########
#.     #
#  . o #
#o#  # #
# @ o# #
#.#. o #
#     ##
########